wwwwwwwwwwwwwwwwwwwww
w...................w
w.........x.........w
w......wwwwwww......w
w......w.....w......w
w......w.....w......w
w......w.....w......w
w......w.....w......w
w.........A.........w
w...................w
w...................w
w...................w
w...................w
wwwwwwwwwwwwwwwwwwwww
